1
52 52 52 52 52 52 52 52 31 52 52 52 52 52 52
52 56 57 53 53 53 53 53 31 47 47 47 47 47 52
52 64 65 53 53 53 53 53 31 47 47 47 47 47 52
52 31 54 53 53 53 53 53 31 47 47 47 47 47 52
52 40 32 32 32 22 32 32 30 32 32 32 32 36 52
52 47 47 47 47 31 47 47 47 47 47 47 47 31 52
52 47 47 47 47 31 47 47 47 47 47 47 47 31 52
52 34 32 32 32 30 32 32 36 47 47 47 47 31 52
52 31 47 47 47 47 47 47 31 47 47 47 47 31 52
32 38 47 47 47 47 47 47 40 32 32 32 32 38 52
52 52 52 52 52 52 52 52 52 52 52 52 52 52 52
0 -1 3 -1
0 0 0 0 0 0 0 0 1 0 0 0 0 0 0
0 0 0 0 0 0 0 0 1 0 0 0 0 0 0
0 3 0 0 0 0 0 0 1 0 0 0 0 0 0
0 1 0 0 0 0 0 0 1 0 0 0 0 0 0
0 1 1 1 1 1 1 1 1 1 1 1 1 1 0
0 0 0 0 0 1 0 0 0 0 0 0 0 1 0
0 0 0 0 0 1 0 0 0 0 0 0 0 1 0
0 1 1 1 1 1 1 1 1 0 0 0 0 1 0
0 1 0 0 0 0 0 0 1 0 0 0 0 1 0
1 1 0 0 0 0 0 0 1 1 1 1 1 1 0
0 0 0 0 0 0 0 0 0 0 0 0 0 0 0
Rock HighLand