2
49 49 49 49 49 49 49 49 49 49 49 49 49 49 49
49 69 70 71 50 34 32 32 32 32 32 32 36 50 49
49 77 78 79 62 31 50 50 50 50 50 50 31 50 49
49 50 40 32 32 38 50 50 50 41 50 50 31 50 49
49 60 50 50 50 50 50 50 50 31 50 50 31 50 49
49 68 32 32 32 32 36 50 50 31 50 50 31 50 49
49 61 50 50 50 50 31 50 50 31 50 50 40 32 32
49 50 50 50 50 50 31 50 50 31 50 50 50 50 49
49 34 32 32 32 32 38 50 50 31 50 50 50 50 49
49 31 50 50 50 50 50 50 50 31 50 50 50 50 49
49 31 49 49 49 49 49 49 49 31 49 49 49 49 49
-1 3 -1 0
0 0 0 0 0 0 0 0 0 0 0 0 0 0 0
0 0 0 0 0 1 1 1 1 1 1 1 1 0 0
0 0 3 0 0 1 0 0 0 0 0 0 1 0 0
0 0 1 1 1 1 0 0 0 1 0 0 1 0 0
0 0 0 0 0 0 0 0 0 1 0 0 1 0 0
0 3 1 1 1 1 1 0 0 1 0 0 1 0 0
0 0 0 0 0 0 1 0 0 1 0 0 1 1 1
0 0 0 0 0 0 1 0 0 1 0 0 0 0 0
0 1 1 1 1 1 1 0 0 1 0 0 0 0 0
0 1 0 0 0 0 0 0 0 1 0 0 0 0 0
0 1 0 0 0 0 0 0 0 1 0 0 0 0 0
Cold Surface