3
51 51 51 51 51 51 51 51 51 51 51 51 51 51 51
51 34 32 32 36 53 53 53 52 53 53 54 58 59 51
51 31 53 53 18 32 32 32 32 32 32 32 32 26 51
51 31 53 53 31 52 53 53 53 53 53 53 53 31 51
51 31 53 53 31 53 52 53 47 47 47 53 53 31 51
51 31 53 53 31 53 53 53 53 53 47 47 53 31 51
32 38 53 53 40 32 32 32 36 53 53 53 53 31 51
51 52 52 52 52 52 53 53 31 53 53 53 52 31 51
51 52 47 47 47 52 53 53 18 32 32 32 32 38 51
51 52 52 52 52 52 53 53 31 53 53 52 53 53 51
51 51 51 51 51 51 51 51 31 51 51 51 51 51 51
2 -1 -1 1
0 0 0 0 0 0 0 0 0 0 0 0 0 0 0
0 1 1 1 1 0 0 0 0 0 0 0 0 3 0
0 1 0 0 1 1 1 1 1 1 1 1 1 1 0
0 1 0 0 1 0 0 0 0 0 0 0 0 1 0
0 1 0 0 1 0 0 0 0 0 0 0 0 1 0
0 1 0 0 1 0 0 0 0 0 0 0 0 1 0
1 1 0 0 1 1 1 1 1 0 0 0 0 1 0
0 0 0 0 0 0 0 0 1 0 0 0 0 1 0
0 0 0 0 0 0 0 0 1 1 1 1 1 1 0
0 0 0 0 0 0 0 0 1 0 0 0 0 0 0
0 0 0 0 0 0 0 0 1 0 0 0 0 0 0
Green Desert