0
67 31 67 67 67 67 67 67 67 31 67 67 67 67 67
67 31 48 48 48 48 48 48 48 40 32 36 48 48 67
67 31 48 63 74 63 48 48 48 48 48 31 48 66 67
67 31 48 48 63 48 48 34 32 32 32 38 48 48 67
67 31 48 48 48 48 48 31 48 48 48 48 48 48 67
67 31 75 75 75 75 75 31 48 34 32 32 32 36 67
67 18 32 32 32 32 32 38 48 31 48 48 48 31 67
67 31 75 75 75 75 75 48 48 31 48 66 48 31 67
67 31 48 48 48 48 48 48 48 31 48 76 48 31 67
67 40 32 32 32 32 32 32 32 38 48 48 48 40 32
67 67 67 67 67 67 67 67 67 67 67 67 67 67 67
-1 1 2 -1
0 1 0 0 0 0 0 0 0 1 0 0 0 0 0
0 1 0 0 0 0 0 0 0 1 1 1 0 0 0
0 1 0 0 4 0 0 0 0 0 0 1 0 0 0
0 1 0 0 2 0 0 1 1 1 1 1 0 0 0
0 1 0 0 2 0 0 1 0 0 0 0 0 0 0
0 1 0 0 2 0 0 1 0 1 1 1 1 1 0
0 1 1 1 1 1 1 1 0 1 0 0 0 1 0
0 1 0 0 0 0 0 0 0 1 0 0 0 1 0
0 1 0 0 0 0 0 0 0 1 0 0 0 1 0
0 1 1 1 1 1 1 1 1 1 0 0 0 1 1
0 0 0 0 0 0 0 0 0 0 0 0 0 0 0
Home Land